SO ./assets/textures/brickwall.xpm
WE ./assets/textures/brickwall.xpm
NO ./assets/textures/brickwall.xpm
EA ./assets/textures/brickwall.xpm

C 0, 0, 50
F 30, 30, 30

11111111111111111111111111111111111111111111111111
100D00000C000010C0000100D0000000100000100000000111
1C010010000000100C0000001000N000001010001100010011
11D1101001001000000110011D111101100101010000001001
1000110010100110010D000000000010001000010010011101
1C00D00010000C000101000000001000110010010100001001
10011C11011111110010001001000101000100100100101001
11111111111111111111111111111111111111111111111111