SO ./assets/textures/brickwall.xpm
WE ./assets/textures/brickwall.xpm
NO ./assets/textures/brickwall.xpm

C 0, 0, 0
F 0, 0, 0
EA ./assets/textures/brickwall.xpm

11111111111111111111111111111111111111111111111111
10000000000000001000010000000000100000100000000111
1001001000000010001100001000N000000010001100010011
11011010010010010100100100111101100101010000001001
10000100101001100100000001000010001000010010011101
10001000100000000101000110001000110010010100001001
10010011011111110010001001000101000100100100101001
10100000000000001000100000011001010000101000001001
10010100011000101010010000100000010000100100010011
11000000100001001011001001001010001001010101000001
10111100101000101000100010001001000001000101001001
10000010101110101010010100001000100110001001000101
11100100100001000100010000101010010000101010100001
10001000100100110011010111010010101101001010010011
10110010000010001000001000010001000001010010001001
10000010001101000110100001000010011100010100100101
10100100100000001000011000101010000010100100010101
10100100010110100101000101001011100010010110000101
10001001010001000000010101011100010100010001100101
11000100000101011111100101001001000101001000000001
10100010000100100000010100101010101000100011100001
10011001111010000001010010101010010100010100000111
11000100000001111001011010100001000001100111001001
10010000111100000001000000111100001110010000000101
10001011000001100100010101000010110000011010010101
11001000011010010011100101010010000100000100100101
10000011100100011000000100001001011001110000010001
10010100010010000101110001100100100010000111001111
10100111010010010010000000011010001000101000100001
10101000010100100010011101100000010001001010010101
11111010100110000100010100001000100010011000100101
10100010001100000100101000110001000000010000100101
10111010100001001000100110001010010111100100011001
11111111111111111111111111111111111111111111111111