SO Text/bluestone_test.xpm
NO Text/grey.xpm
EA Text/metal_wall.xpm
WE Text/marbel.xpm

C 255, 0, 69
F 31, 1, 1

111111
100101
101001


1100W1
111101