SO Text/graywalls.xpm
NO Text/grey.xpm
EA Text/metal_wall.xpm
WE Text/marbel.xpm

C 255, 0, 69
F 31, 1, 1

111111
100101
101C01
1100W1
111111